NO ./textures/nord.xpm
SO ./textures/sud.xpm
WE ./textures/ovest.xpm
EA ./textures/est.xpm

F 220,100,0
C 225,30,0




1111111
1111001
1001001
1010011
110N01
111111
