NO ./textures/nord.xpm
SO ./textures/sud.xpm
WE ./textures/ovest.xpm
EA ./textures/est.xpm

F 220,100,0
C 225,30,0





		 111111
100101
101001
110N01
111111
