22222222111111111111111111111111122222222222222222222
22222222100000000011000000000000122222222222222222222
22222222101100000111000000000000122222222222222222222
22222222100100000000000000000000122222222222222222222
11111111101100000111000000000000122222222222222222222
10000000001100000111011111111111122222222222222222222
11110111111111011100000010001222222222222222222222222
11110111111111011101010010001222222222222222222222222
11000000110101011100000010001222222222222222222222222
10000000000000001100000010001222222222222222222222222
10000000000000001101D10010001222222222222222222222222
10000000000000000000000000001222222222222222222222222
10000000000000000000000000001222222222222222222222222
10000000000000000000000000001222222222222222222222222
10000000000000N00000000000001222222222222222222222222
10000000000000000000Z00000001222222222222222222222222
10000000000000000000000000001222222222222222222222222
100000000000000000Z0000000001222222222222222222222222
10000000000000000000000000001222222222222222222222222
10000000000000000000000000001222222222222222222222222
10000000000000000000000000001222222222222222222222222
10000000000000000000000000001222222222222222222222222
10000000000000000000000000001222222222222222222222222
11111111111111111111111111111222222222222222222222222
11110111211101012101111010001222222222222222222222222
11111111211111112111111111111222222222222222222222222
