NO ./textures/redbrick.xpm
SO ./textures/eagle.xpm
WE ./textures/wall_3.xpm
EA ./textures/wood.xpm

F 0,0,0
C 255,255,                                     255

    1111111        111
    1000001        101           
11111000001       111111
10000NZ0001
10100111111
110001
111111
