NO ./textures/redbrick.xpm
SO ./textures/eagle.xpm
WE ./textures/wall_3.xpm
EA ./textures/wood.xpm

F 0,0,0
C 255,255,                                     255

    1111111        111
    1000001        101           
1111100N001       111111
1000000Z001
10100111111
11Z001
111111
