NO ./textures/walls/walls5.xpm
SO ./textures/walls/walls2.xpm
WE ./textures/walls/walls3.xpm
EA ./textures/walls/walls6.xpm

F 0,0,0
C 255,255,                                     255

        1111111111111111111111111
        1000000000110000000000001
        1011000001110000000000001
        1001000000000000000000001
111111111011000001110000000000001  
100000000011000001110111111111111
11110111111111011100000010001
11110111111111011101010010001
11000000110101011100000010001
10000000000000001100000010001
10000000000000001101D10010001
10000000000000000000000000001
10000000000000000000000000001
10000000000000000000000000001
10000000000000N00000000000001
10000000000000000000Z00000001
10000000000000000000000000001
100000000000000000Z0000000001
10000000000000000000000000001
10000000000000000000000000001
10000000000000000000000000001
10000000000000000000000000001
10000000000000000000000000001
11111111111111111111111111111
11110111 1110101 101111010001                       
11111111 1111111 111111111111